NO texture/stone.xpm42
SO texture/wood.xpm42

WE texture/idk.xpm42
EA texture/brick.xpm42

F 0,130,70
C 0,0,70


1111111111111
1E00000000001
1000000111001
1100000111101
1111111111111